00000000000000000000000000000000000000000000000000
00000000000000000000000000000000000000000000000000
00000000000000000000000000000000000000000000000000
00000000000000000000000000000000000000000000000000
00000000000000000000000300000000000000000000000000
00000000000030000000111111000011100000000000000000
00000000000110000010000000001000000000000000010000
00003100110100010000000000010000000011000000110000
00011100003300000001000000100000000000100001110000
11111111111111111111100111111100000111111111111111