0000000000000000000000000000000000000000000000000000000000000000000000000000000000000000000000000000
0000000000000000000000000000000000000000000000000000000000000000000000000000000000000000000000000000
0000000000000000000000000000000000000000000000000000000000000000000000000000000000000000000000000000
0000000000000000000000000000000000000000000000000000000000000000000000000000000000000000000000000000
0000000000000000000000030000000000000000000000000000000000000000000000000000000000000000000000000000
0000000000000000000601111110001110000000000000003000000030000000000000000000000000000000000000000000
0000000000011000000600000000100000000000000001111111111111100000000000000000000000000000000000000000
0000010011110000000600000001100000000000000011111111111111111000000000000000000010000000000000100000
0001110000010001111000000011100000000000000111111111111111111100000000000000000110000011003001100050
1111111111111111111110011111110000011111111111111111111111111111114444444444411100000111111111111111